sezione,votanti,votantiUomini,votantiDonne,ubicazione,numeroElettori,affluenzaPercentuale
307,522,235,287,"SCUOLA PRIMARIA ""G.FAVA"" VIA MONTE S.CALOGERO N.20",815,64.0490797546
185,557,266,291,"SCUOLA PRIMARIA ""RAPISARDI"" VIA CALTANISSETTA N.27",870,64.0229885057
176,560,251,309,"SCUOLA PRIMARIA ""ALMEJDA - PITRE'"" VIA DAMIANI ALMEJDA N.27",893,62.7099664054
238,513,241,272,"SCUOLA PRIMARIA ""BORSELLINO"" VIA GIOTTO N.41",838,61.2171837709
141,423,194,229,"SCUOLA SECOND.I GRADO ""V.E.ORLANDO"" VIA LUSSEMBURGO N.103",698,60.6017191977
216,602,288,314,"SCUOLA PRIMARIA ""G.FAVA"" VIA MONTE S.CALOGERO N.20",994,60.5633802817
293,420,202,218,"SCUOLA SECOND.I GRADO ""V.E.ORLANDO"" VIA LUSSEMBURGO N.103",694,60.5187319885
513,501,249,252,"SCUOLA PRIMARIA ""TRINACRIA"" VIA TRINACRIA N.1",829,60.4342581423
535,601,296,305,"SCUOLA SECOND. DI I GRADO ""PIAZZI"" VIA RUTELLI MARIO N.50",995,60.4020100503
302,614,314,300,"SCUOLA PRIMARIA ""PAULSEN"" P.LE CARPINO FRANCESCO CARD. N.3",1018,60.3143418468
558,520,230,290,"SCUOLA PRIMARIA ""GARZILLI"" VIA ISONZO N.7",863,60.2549246813
576,516,241,275,"DIREZIONE DIDATTICA ""DE GASPERI"" PIAZZA GIOVANNI PAOLO II PAPA N.24",858,60.1398601399
21,607,297,310,"SCUOLA PRIMARIA E INFANZIA ""M.GANDHI"" VIA SARDEGNA N.55",1011,60.0395647873
191,564,262,302,"SCUOLA SECOND.I GRADO ""GENTILI"" VIA LO JACONO FRANCESCO N.1",943,59.8091198303
555,554,267,287,"SCUOLA PRIMARIA ""GARZILLI"" VIA ISONZO N.7",928,59.6982758621
363,594,260,334,"SCUOLA SECOND. DI I GRADO ""PIAZZI"" VIA RUTELLI MARIO N.50",998,59.5190380762
20,499,235,264,"SCUOLA PRIMARIA ""G.FAVA"" VIA MONTE S.CALOGERO N.20",839,59.4755661502
508,419,202,217,"SCUOLA SECOND.I GRADO ""V.E.ORLANDO"" VIA LUSSEMBURGO N.103",705,59.4326241135
464,516,256,260,"SCUOLA PRIMARIA ""GARZILLI"" VIA ISONZO N.7",869,59.3785960875
526,600,274,326,"SCUOLA DELL'INFANZIA ""TOMASELLI"" VIA ABRUZZI N.2",1011,59.3471810089
328,545,271,274,"SCUOLA PRIMARIA ""BRAGAGLIA"" VIA BRAGAGLIA MARINELLA N.23",919,59.3035908596
407,463,205,258,"DIREZIONE DIDATTICA ""DE GASPERI"" PIAZZA GIOVANNI PAOLO II PAPA N.24",781,59.2829705506
42,462,223,239,"SCUOLA PRIMARIA ""SUNSERI"" VIA SUNSERI GIUSEPPE N.19",780,59.2307692308
561,636,299,337,"SCUOLA PRIMARIA E INFANZIA ""M.GANDHI"" VIA SARDEGNA N.55",1074,59.217877095
470,580,259,321,"SCUOLA PRIMARIA ""ALMEJDA - PITRE'"" VIA DAMIANI ALMEJDA N.27",981,59.123343527
178,628,290,338,"SCUOLA PRIMARIA ""ALMEJDA - PITRE'"" VIA DAMIANI ALMEJDA N.27",1064,59.022556391
452,571,295,276,"SCUOLA PRIMARIA ""BERNINI"" VIA PAPALEO PIETRO N.8",968,58.9876033058
310,439,237,202,"DIREZIONE DIDATTICA ""DE GASPERI"" PIAZZA GIOVANNI PAOLO II PAPA N.24",745,58.9261744966
177,509,229,280,"SCUOLA PRIMARIA ""RAPISARDI"" VIA CALTANISSETTA N.27",865,58.8439306358
143,418,190,228,"SCUOLA SECOND.I GRADO ""V.E.ORLANDO"" VIA LUSSEMBURGO N.103",711,58.7904360056
428,492,227,265,"SCUOLA PRIMARIA ""GIOVANNI XXIII"" VIA SAMPOLO N.63",838,58.7112171838
52,474,217,257,"SCUOLA SECOND.I GR. ""LEONARDO DA VINCI"" VIA DI GIORGI FERDINANDO N.48",808,58.6633663366
173,531,236,295,"SCUOLA SECOND.I GRADO ""GENTILI"" VIA LO JACONO FRANCESCO N.1",907,58.5446527012
577,490,234,256,"SCUOLA PRIMARIA ""GARZILLI"" VIA ISONZO N.7",840,58.3333333333
179,485,233,252,"SC.SECOND.I GRADO ""DEL FERVORE"" VIA DEL FERVORE N.5",833,58.2232893157
116,535,267,268,"SCUOLA PRIMARIA ""LA MASA"" VIA LA MASA GIUSEPPE N.17",919,58.2154515778
209,440,206,234,"SCUOLA PRIMARIA E INFANZIA ""M.GANDHI"" VIA SARDEGNA N.55",758,58.0474934037
436,526,254,272,"SCUOLA SECOND.I GR.E PRIM.""VERDI"" VIA CASELLA ALFREDO N.35",908,57.9295154185
367,679,338,341,"SCUOLA PRIMARIA ""PASCOLI"" VIA NETTUNO N.7",1173,57.8857630009
554,498,227,271,"SCUOLA PRIMARIA ""GARZILLI"" VIA ISONZO N.7",862,57.7726218097
506,414,197,217,"SCUOLA PRIMARIA ""SUNSERI"" VIA SUNSERI GIUSEPPE N.19",718,57.6601671309
137,423,207,216,"SCUOLA SECOND.I GRADO ""V.E.ORLANDO"" VIA LUSSEMBURGO N.103",735,57.5510204082
145,418,196,222,"DIREZIONE DIDATTICA ""DE GASPERI"" PIAZZA GIOVANNI PAOLO II PAPA N.24",727,57.4965612105
34,551,310,241,"SCUOLA SECOND. DI I GRADO ""VERDI"" VIA FERMI ENRICO N.2",961,57.3361082206
358,474,228,246,"SCUOLA SECOND.I GR. ""LEONARDO DA VINCI"" VIA DI GIORGI FERDINANDO N.48",828,57.2463768116
172,581,260,321,"SCUOLA SECOND. DI I GRADO ""PIAZZI"" VIA RUTELLI MARIO N.50",1015,57.2413793103
296,459,223,236,"SCUOLA PRIM.E DELL'INFANZ.""LAMBRUSCHINI"" VIA DON GIOVANNI MINZONI N.1",802,57.2319201995
170,631,301,330,"SCUOLA SECOND. DI I GRADO ""PIAZZI"" VIA RUTELLI MARIO N.50",1103,57.2076155938
392,616,312,304,"SCUOLA PRIMARIA ""ROSARIO GREGORIO"" VIA MARINAI ALLIATA N.33",1077,57.1959145775
97,563,254,309,"SCUOLA PRIMARIA ""UMBERTO GIORDANO"" VIA DAIDONE N.24",985,57.1573604061
153,581,294,287,"SCUOLA PRIMARIA ""GIOVANNI XXIII"" VIA SAMPOLO N.63",1017,57.1288102262
68,602,285,317,"SCUOLA DELL'INFANZIA ""TOMASELLI"" VIA ABRUZZI N.2",1055,57.0616113744
499,531,254,277,"SCUOLA SECOND.I GR.E PRIM.""VERDI"" VIA CASELLA ALFREDO N.35",932,56.974248927
157,418,197,221,"SCUOLA SECOND. DI I GRADO ""VERDI"" VIA FERMI ENRICO N.2",734,56.9482288828
22,527,242,285,"SCUOLA SECOND.I GR.E PRIM.""VERDI"" VIA CASELLA ALFREDO N.35",926,56.9114470842
106,533,266,267,"SCUOLA PRIMARIA ""SAN LORENZO"" VIA S.LORENZO N.89",937,56.8836712914
557,510,227,283,"SCUOLA PRIMARIA ""TRINACRIA"" VIA TRINACRIA N.1",897,56.856187291
96,457,222,235,"SCUOLA PRIMARIA ""G.FAVA"" VIA MONTE S.CALOGERO N.20",804,56.8407960199
364,569,275,294,"SCUOLA PRIMARIA ""GARZILLI"" VIA ISONZO N.7",1002,56.7864271457
88,509,263,246,"SCUOLA PRIMARIA ""BRAGAGLIA"" VIA BRAGAGLIA MARINELLA N.23",897,56.7447045708
149,468,216,252,"SCUOLA PRIMARIA ""G.FAVA"" VIA MONTE S.CALOGERO N.20",825,56.7272727273
237,627,317,310,"SCUOLA PRIMARIA ""GABELLI"" VIA EUGENIO L'EMIRO N.30",1106,56.6907775769
501,558,265,293,"SCUOLA SECOND. DI I GRADO ""PIAZZI"" VIA RUTELLI MARIO N.50",987,56.5349544073
465,525,240,285,"SCUOLA SECOND.DI I GRADO ""MARCONI"" VIA DI GIORGIO ANTONINO GEN. N.4",929,56.512378902
26,439,226,213,"SCUOLA SECOND.I GR. ""LEONARDO DA VINCI"" VIA DI GIORGI FERDINANDO N.48",777,56.4993564994
77,369,188,181,"SCUOLA PRIMARIA ""BERNINI"" VIA PAPALEO PIETRO N.8",654,56.4220183486
148,553,259,294,"SCUOLA SECOND. DI I GRADO ""PIAZZI"" VIA RUTELLI MARIO N.50",982,56.3136456212
213,483,221,262,"SCUOLA PRIMARIA ""COLLODI"" VIA BRIUCCIA N.89",859,56.2281722934
283,529,244,285,"SCUOLA PRIMARIA ""COLLODI"" VIA BRIUCCIA N.89",941,56.2167906482
360,548,270,278,"SCUOLA PRIMARIA ""VITTORINO DA FELTRE"" Corso Calatafimi n. 1035",977,56.0900716479
165,438,203,235,"SCUOLA SECOND.I GR. ""LEONARDO DA VINCI"" VIA DI GIORGI FERDINANDO N.48",781,56.0819462228
525,609,298,311,"SCUOLA DELL'INFANZIA ""TOMASELLI"" VIA ABRUZZI N.2",1087,56.0257589696
94,507,231,276,"SCUOLA PRIMARIA ""TRINACRIA"" VIA TRINACRIA N.1",905,56.0220994475
391,652,332,320,"SCUOLA PRIMARIA ""PASCOLI"" VIA NETTUNO N.7",1164,56.0137457045
210,535,265,270,"SCUOLA PRIMARIA ""SAN LORENZO"" VIA S.LORENZO N.89",958,55.8455114823
183,407,189,218,"SCUOLA PRIMARIA ""RAPISARDI"" VIA CALTANISSETTA N.27",729,55.8299039781
240,513,238,275,"SCUOLA PRIMARIA ""BORSELLINO"" VIA GIOTTO N.41",919,55.8215451578
180,422,197,225,"SCUOLA PRIMARIA ""RAPISARDI"" VIA CALTANISSETTA N.27",756,55.8201058201
32,579,285,294,"SCUOLA PRIMARIA ""D'ANGELO PAOLO EMILIO"" VIA S.LORENZO N.295",1039,55.7266602502
546,490,241,249,"SCUOLA SECOND.I GR. ""LEONARDO DA VINCI"" VIA DI GIORGI FERDINANDO N.48",881,55.61861521
574,544,262,282,"SCUOLA PRIMARIA ""PALAGONIA"" VIA PRINCIPE DI PALAGONIA N.46",981,55.4536187564
70,439,221,218,"SCUOLA PRIMARIA ""MONTEGRAPPA"" VIA ROCCELLA GUSTAVO N.37",793,55.3593947037
93,385,176,209,"SCUOLA SECOND.I GRADO ""A.GRAMSCI"" VIA ARCOLEO GIUSEPPE N.78",696,55.316091954
404,385,178,207,"SCUOLA PRIMARIA ""TRINACRIA"" VIA TRINACRIA N.1",696,55.316091954
445,505,267,238,"SCUOLA PRIMARIA ""BENTIVEGNA"" VIA S.LORENZO N.85",914,55.2516411379
512,505,267,238,"SCUOLA SEC. 1Â° GRADO ""SALEMI"" VIA SALEMI FRANCESCO GEN. N.22",914,55.2516411379
100,537,265,272,"SCUOLA PRIMARIA ""D'ANGELO PAOLO EMILIO"" VIA S.LORENZO N.295",972,55.2469135802
429,548,261,287,"SCUOLA PRIMARIA ""GIOVANNI XXIII"" VIA SAMPOLO N.63",992,55.2419354839
64,480,239,241,"SCUOLA PRIMARIA ""DE STEFANO"" VIA DE STEFANO ANTONINO N.1/C",869,55.2359033372
25,688,340,348,"SCUOLA PRIMARIA ""PAULSEN"" P.LE CARPINO FRANCESCO CARD. N.3",1247,55.1724137931
401,445,213,232,"SCUOLA PRIMARIA ""F.CRISPI"" INGR.PAD.1 VIA BARISANO DA TRANI N.7",807,55.1425030979
60,480,221,259,"SCUOLA SECOND.I GRADO ""GENTILI"" VIA LO JACONO FRANCESCO N.1",871,55.1090700344
56,491,246,245,"SCUOLA PRIMARIA ""SALGARI"" VIA PARATORE GIUSEPPE N.34",891,55.1066217733
184,424,191,233,"SCUOLA PRIMARIA ""RAPISARDI"" VIA CALTANISSETTA N.27",770,55.0649350649
479,508,253,255,"SCUOLA SECOND.DI I GRADO ""MARCONI"" VIA DI GIORGIO ANTONINO GEN. N.4",923,55.0379198267
346,430,190,240,"SCUOLA SECOND. DI I GRADO ""VERDI"" VIA FERMI ENRICO N.2",782,54.9872122762
395,652,334,318,"SCUOLA PRIMARIA ""ROSARIO GREGORIO"" VIA MARINAI ALLIATA N.33",1188,54.8821548822
66,648,330,318,"SCUOLA PRIMARIA ""PASCOLI"" VIA NETTUNO N.7",1181,54.8687552921
575,514,241,273,"SCUOLA PRIMARIA E INFANZIA ""M.GANDHI"" VIA SARDEGNA N.55",937,54.855923159
494,599,309,290,"SCUOLA PRIMARIA ""SAN DOMENICO SAVIO"" VIALE DELLA RESURREZIONE N.1",1092,54.8534798535
18,478,220,258,"SCUOLA PRIMARIA ""UMBERTO GIORDANO"" VIA DAIDONE N.24",872,54.8165137615
147,499,232,267,"DIREZIONE DIDATTICA ""DE GASPERI"" PIAZZA GIOVANNI PAOLO II PAPA N.24",911,54.7749725576
33,534,258,276,"SCUOLA PRIMARIA ""GIOVANNI XXIII"" VIA SAMPOLO N.63",975,54.7692307692
517,433,224,209,"SCUOLA PRIMARIA ""MEDAGLIE D'ORO"" VIA DEODATO PIER LUIGI N.7",791,54.7408343869
144,529,249,280,"SCUOLA PRIMARIA ""COLLODI"" VIA BRIUCCIA N.89",967,54.7052740434
568,618,303,315,"SCUOLA SECOND. DI I GRADO ""MATTARELLA"" VIA BONAGIA N.14",1130,54.6902654867
422,461,215,246,"SCUOLA SECOND.DI I GRADO ""MARCONI"" VIA DI GIORGIO ANTONINO GEN. N.4",843,54.6856465006
171,558,257,301,"SCUOLA SECOND.I GRADO ""GENTILI"" VIA LO JACONO FRANCESCO N.1",1021,54.652301665
416,441,221,220,"SCUOLA PRIMARIA ""ROSMINI"" VIA CRUILLAS N.4",807,54.6468401487
91,624,304,320,"SCUOLA PRIMARIA ""PASCOLI"" VIA NETTUNO N.7",1142,54.6409807356
518,516,226,290,"SCUOLA SECOND.I GR.""GARIBALDI"" VIA DELLE CROCI N.5",945,54.6031746032
142,589,284,305,"SCUOLA SECOND.I GR.""GARIBALDI"" VIA DELLE CROCI N.5",1080,54.537037037
48,559,287,272,"SCUOLA DELL'INFANZIA ""PALADINI"" PIAZZA CELLINI BENVENUTO N.4",1025,54.5365853659
600,601,317,284,"SCUOLA PRIMARIA ""SAN DOMENICO SAVIO"" VIALE DELLA RESURREZIONE N.1",1103,54.4877606528
351,396,189,207,"SCUOLA SECOND.I GRADO ""A.GRAMSCI"" VIA ARCOLEO GIUSEPPE N.78",728,54.3956043956
567,588,294,294,"SCUOLA PRIMARIA ""PAULSEN"" P.LE CARPINO FRANCESCO CARD. N.3",1081,54.394079556
495,421,204,217,"SCUOLA SECOND.I GRADO ""A.GRAMSCI"" VIA ARCOLEO GIUSEPPE N.78",774,54.3927648579
353,446,215,231,"SCUOLA PRIMARIA ""DONAUDY"" PIAZZA DONAUDY STEFANO N.16",820,54.3902439024
123,472,223,249,"SCUOLA PRIMARIA ""MONTEGRAPPA"" VIA ROCCELLA GUSTAVO N.37",868,54.3778801843
350,517,237,280,"SCUOLA SECOND.DI I GRADO ""MARCONI"" VIA DI GIORGIO ANTONINO GEN. N.4",951,54.3638275499
174,484,232,252,"SCUOLA PRIMARIA ""BORSELLINO"" VIA GIOTTO N.41",891,54.3209876543
62,501,243,258,"SCUOLA PRIMARIA ""TRINACRIA"" VIA TRINACRIA N.1",923,54.2795232936
168,465,219,246,"SCUOLA PRIMARIA ""UMBERTO GIORDANO"" VIA DAIDONE N.24",857,54.2590431739
118,506,251,255,"SCUOLA PRIMARIA ""LA MASA"" VIA LA MASA GIUSEPPE N.17",934,54.1755888651
497,482,249,233,"SCUOLA PRIMARIA ""DI BARTOLO"" LUNGOMARE COLOMBO CRISTOFORO N.240",890,54.1573033708
405,515,244,271,"SCUOLA DELL'INFANZIA ""TOMASELLI"" VIA ABRUZZI N.2",951,54.1535226078
212,550,277,273,"SCUOLA DELL'INFANZIA ""TOMASELLI"" VIA ABRUZZI N.2",1016,54.1338582677
87,467,231,236,"DIREZIONE DIDATTICA ""DE GASPERI"" PIAZZA GIOVANNI PAOLO II PAPA N.24",865,53.9884393064
466,562,284,278,"SCUOLA PRIMARIA ""ROSARIO GREGORIO"" VIA MARINAI ALLIATA N.33",1041,53.9865513929
532,484,243,241,"SCUOLA PRIMARIA ""GIOVANNI XXIII"" VIA SAMPOLO N.63",897,53.9576365663
38,420,200,220,"SCUOLA PRIMARIA ""DE STEFANO"" VIA DE STEFANO ANTONINO N.1/C",779,53.9152759949
403,462,224,238,"SCUOLA SECOND.DI I GRADO ""MARCONI"" VIA DI GIORGIO ANTONINO GEN. N.4",858,53.8461538462
503,455,224,231,"SCUOLA PRIM.E DELL'INFANZ.""LAMBRUSCHINI"" VIA DON GIOVANNI MINZONI N.1",846,53.7825059102
187,441,206,235,"SC.SECOND.I GRADO ""DEL FERVORE"" VIA DEL FERVORE N.5",820,53.7804878049
394,657,328,329,"SCUOLA PRIMARIA ""RISO"" VIA MONDELLO N.5",1222,53.7643207856
200,536,285,251,"SCUOLA PRIMARIA ""VERGA"" VIA UDITORE N.21",999,53.6536536537
430,553,270,283,"SCUOLA SECOND. DI I GRADO ""MATTARELLA"" VIA BONAGIA N.14",1032,53.5852713178
44,466,211,255,"SCUOLA PRIMARIA ""UMBERTO GIORDANO"" VIA DAIDONE N.24",870,53.5632183908
578,587,295,292,"SCUOLA SECOND.I GR. ""LEONARDO DA VINCI"" VIA DI GIORGI FERDINANDO N.48",1096,53.5583941606
117,500,248,252,"SCUOLA PRIMARIA ""LA MASA"" VIA LA MASA GIUSEPPE N.17",934,53.5331905782
412,509,258,251,"SCUOLA PRIMARIA ""BENTIVEGNA"" VIA S.LORENZO N.85",951,53.5226077813
355,497,237,260,"SCUOLA PRIMARIA ""BRAGAGLIA"" VIA BRAGAGLIA MARINELLA N.23",929,53.4983853606
505,468,234,234,"SCUOLA PRIMARIA ""RAGUSA MOLETI"" VIA RAGUSA MOLETI N.8",876,53.4246575342
573,493,238,255,"SCUOLA PRIMARIA ""BORSELLINO"" VIA GIOTTO N.41",924,53.354978355
381,490,256,234,"SCUOLA PRIMARIA ""ROSMINI"" VIA CRUILLAS N.4",919,53.3188248096
128,515,256,259,"SCUOLA SECOND.I GRADO ""ARCHIMEDE"" PIAZZA CASTELNUOVO N.40",966,53.3126293996
432,411,202,209,"SCUOLA PRIMARIA ""MANZONI"" VIA PARLATORE FILIPPO N.56",773,53.169469599
250,522,261,261,"SCUOLA PRIMARIA ""SALGARI"" VIA PARATORE GIUSEPPE N.34",982,53.1568228106
563,514,251,263,"SCUOLA PRIMARIA ""SAN DOMENICO SAVIO"" VIALE DELLA RESURREZIONE N.1",967,53.1540847983
533,450,208,242,"SCUOLA PRIMARIA ""GIOVANNI XXIII"" VIA SAMPOLO N.63",847,53.1286894923
491,562,281,281,"SCUOLA PRIMARIA ""PAULSEN"" P.LE CARPINO FRANCESCO CARD. N.3",1059,53.0689329556
198,446,211,235,"SC.SECOND.I GRADO ""DEL FERVORE"" VIA DEL FERVORE N.5",841,53.0321046373
192,537,270,267,"SCUOLA SECOND.I GRADO ""ARCHIMEDE"" PIAZZA CASTELNUOVO N.40",1013,53.0108588351
65,489,212,277,"SCUOLA SECOND.I GR. ""LEONARDO DA VINCI"" VIA DI GIORGI FERDINANDO N.48",923,52.9794149512
365,403,210,193,"SCUOLA PRIMARIA ""SUNSERI"" VIA SUNSERI GIUSEPPE N.19",761,52.9566360053
511,540,258,282,"SCUOLA PRIMARIA ""GIOVANNI XXIII"" VIA SAMPOLO N.63",1020,52.9411764706
290,470,223,247,"SCUOLA PRIMARIA ""ROSOLINO PILO"" VIA LA FRANCA SEBASTIANO N.70",888,52.9279279279
478,578,285,293,"SCUOLA PRIMARIA ""BENTIVEGNA"" VIA S.LORENZO N.85",1093,52.8819762123
201,453,225,228,"SCUOLA PRIMARIA ""NICOLO' TURRISI"" PZZA ORLANDO VITTORIO EMANUELE N.3",857,52.8588098016
109,383,184,199,"SCUOLA PRIMARIA ""COLLODI"" VIA BRIUCCIA N.89",725,52.8275862069
426,530,259,271,"SCUOLA PRIM.E DELL'INFANZ.""LAMBRUSCHINI"" VIA DON GIOVANNI MINZONI N.1",1008,52.5793650794
208,480,230,250,"SCUOLA PRIMARIA ""PALAGONIA"" VIA PRINCIPE DI PALAGONIA N.46",913,52.573932092
467,472,227,245,"SCUOLA PRIMARIA ""BRAGAGLIA"" VIA BRAGAGLIA MARINELLA N.23",898,52.561247216
451,504,256,248,"SCUOLA SECOND.I GR.""TOMASI DI LAMPEDUSA"" VIALE LEONARDO DA VINCI N.504",961,52.4453694069
434,439,226,213,"SCUOLA PRIMARIA ""ROSMINI"" VIA CRUILLAS N.4",838,52.3866348449
396,593,321,272,"SCUOLA PRIMARIA ""ROSARIO GREGORIO"" VIA MARINAI ALLIATA N.33",1132,52.3851590106
389,628,298,330,"SCUOLA PRIMARIA ""PASCOLI"" VIA NETTUNO N.7",1200,52.3333333333
462,534,278,256,"SCUOLA SECOND.I GR.""LEONARDO DA VINCI"" VIA SERRADIFALCO N.190",1022,52.2504892368
448,411,207,204,"SCUOLA PRIMARIA ""DE AMICIS E"" VIA SAURO NAZARIO N.11",788,52.1573604061
39,502,251,251,"SCUOLA PRIMARIA ""GABELLI"" VIA EUGENIO L'EMIRO N.30",964,52.0746887967
194,488,238,250,"SCUOLA PRIMARIA ""NICOLO' TURRISI"" PZZA ORLANDO VITTORIO EMANUELE N.3",938,52.0255863539
260,579,282,297,"SCUOLA PRIMARIA ""BORSELLINO"" VIA GIOTTO N.41",1113,52.0215633423
312,502,260,242,"SCUOLA SEC. 1Ã?Â° GRADO ""ASTORINO"" VIA ASTORINO GERARDO N.21",965,52.0207253886
81,481,236,245,"SCUOLA PRIMARIA ""SAN LORENZO"" VIA S.LORENZO N.89",925,52.0
223,327,149,178,"SCUOLA PRIMARIA ""ETTORE ARCULEO"" VIA SCHIFANI VITO N.3",631,51.822503962
331,450,240,210,"SCUOLA PRIM.""ILARIA ALPI""(A CROCEVERDE) CORSO DEI MILLE N.1672",869,51.7836593786
456,590,294,296,"SCUOLA PRIMARIA ""NUOVO PAGLIARELLI"" VIA VILLANI GIOVANNI N.40",1140,51.7543859649
35,610,312,298,SCUOLA PRIMARIA SANTOCANALE Via Polibio 1/b,1179,51.7387616624
433,611,317,294,SCUOLA PRIMARIA SANTOCANALE Via Polibio 1/b,1181,51.7358171041
278,419,208,211,"ISTITUTO COMPRENSIVO ""FALCONE"" VIA BASILE ERNESTO N.170",810,51.7283950617
27,482,250,232,"SCUOLA PRIMARIA ""IGNAZIO BUTTITTA"" VIA CIMABUE GIOVANNI N.20",932,51.7167381974
411,491,233,258,"SCUOLA PRIMARIA ""BENTIVEGNA"" VIA S.LORENZO N.85",950,51.6842105263
357,550,284,266,"SCUOLA PRIMARIA ""PAULSEN"" P.LE CARPINO FRANCESCO CARD. N.3",1066,51.5947467167
90,473,240,233,"SCUOLA PRIMARIA ""SALGARI"" VIA PARATORE GIUSEPPE N.34",917,51.5812431843
463,485,219,266,"SCUOLA SECOND.I GR.E PRIM.""VERDI"" VIA CASELLA ALFREDO N.35",942,51.4861995754
61,556,264,292,"SCUOLA PRIMARIA ""IGNAZIO BUTTITTA"" VIA CIMABUE GIOVANNI N.20",1080,51.4814814815
195,460,221,239,SCUOLA DELL'INFANZIA ZS 10 VIA PALAZZOTTO F.P. E G.B. N. 5,894,51.4541387025
490,432,234,198,"SCUOLA PRIM.""ILARIA ALPI""(A CROCEVERDE) CORSO DEI MILLE N.1672",841,51.3674197384
108,548,278,270,"SCUOLA PRIMARIA E DELL'INF. ""SALERNO"" VIA SALERNO N.19",1067,51.358950328
24,441,230,211,"SCUOLA PRIM.E DELL'INF.""CASTELLANA"" VIA CASTELLANA N.40",859,51.338766007
253,377,197,180,"SCUOLA PRIM.E DELL'INF.""BAVIERA"" VIA BAVIERA GIOVANNI N.22",735,51.2925170068
161,425,219,206,"SCUOLA SECOND.I GRADO ""DANTE ALIGHIERI"" VIA MARTURANO RUGGERO N.79",829,51.2665862485
414,537,272,265,"SCUOLA SEC. 1Ã?Â° GRADO ""ASTORINO"" VIA ASTORINO GERARDO N.21",1049,51.1916110582
262,482,239,243,"SCUOLA PRIMARIA ""RIZZO"" VIA SERGIO PAPA I N.21/D",942,51.1677282378
382,505,264,241,"SCUOLA PRIMARIA ""TOMMASO NATALE"" VIA LIMONE N.19",989,51.0616784631
385,598,319,279,"SCUOLA PRIMARIA ""TEN. ONORATO"" VIA TACITO N.34",1172,51.023890785
435,413,217,196,"SCUOLA PRIMARIA ""MANZONI"" VIA PARLATORE FILIPPO N.56",813,50.7995079951
130,448,228,220,"SCUOLA PRIMARIA ""NATOLI"" CORSO DEI MILLE N.1486",883,50.7361268403
469,439,220,219,"SCUOLA PRIMARIA ""DONAUDY"" PIAZZA DONAUDY STEFANO N.16",866,50.6928406467
498,507,259,248,"SCUOLA PRIMARIA ""RIZZO"" VIA SERGIO PAPA I N.21/D",1001,50.6493506494
215,525,259,266,"SCUOLA SEC. 1Â° GRADO ""SALEMI"" VIA SALEMI FRANCESCO GEN. N.22",1037,50.6268081003
197,420,210,210,"SC.SECOND.I GRADO ""DEL FERVORE"" VIA DEL FERVORE N.5",831,50.5415162455
270,424,223,201,"SCUOLA SECOND.DI I GRADO ""MAZZINI"" VIA DE MARIA FEDERICO N.36",841,50.4161712247
390,552,272,280,"SCUOLA PRIMARIA ""PASCOLI"" VIA NETTUNO N.7",1096,50.3649635036
362,636,330,306,"SCUOLA PRIMARIA ""ANDREA SOLE"" VIA MOLARA N.30",1263,50.3562945368
598,425,222,203,"SCUOLA PRIMARIA ""RIZZO"" VIA SERGIO PAPA I N.21/D",844,50.355450237
4,580,299,281,"SCUOLA PRIMARIA ""VITALI"" VIA INSERRA N.1",1152,50.3472222222
248,521,267,254,"SCUOLA PRIMARIA ""LOMBARDO RADICE"" CORSO CALATAFIMI N.241",1035,50.3381642512
530,439,203,236,"SCUOLA SECOND. DI I GRADO ""PIAZZI"" VIA RUTELLI MARIO N.50",874,50.2288329519
453,347,173,174,"SCUOLA PRIMARIA ""ROSMINI"" VIA CRUILLAS N.4",691,50.2170767004
375,584,301,283,"SCUOLA PRIMARIA ""MANTEGNA"" VIA BOLOGNI N.4",1165,50.1287553648
46,483,247,236,"SCUOLA PRIMARIA ""D'ANGELO PAOLO EMILIO"" VIA S.LORENZO N.295",964,50.1037344398
400,381,205,176,"SCUOLA SECOND.DI I GRADO ""BORGESE"" PIAZZA FERRINI CONTARDO N.13",761,50.0657030223
251,438,224,214,"SCUOLA PRIMARIA ""LOMBARDO RADICE"" CORSO CALATAFIMI N.241",875,50.0571428571
104,474,241,233,"SCUOLA SECOND. DI I GRADO ""MATTARELLA"" VIA BONAGIA N.14",949,49.947312961
431,521,275,246,"SCUOLA PRIMARIA ""D'ANGELO PAOLO EMILIO"" VIA S.LORENZO N.295",1044,49.9042145594
562,422,212,210,"SCUOLA PRIMARIA ""RIZZO"" VIA SERGIO PAPA I N.21/D",846,49.8817966903
397,481,235,246,"SCUOLA PRIMARIA ""SAN DOMENICO SAVIO"" VIALE DELLA RESURREZIONE N.1",966,49.7929606625
383,439,229,210,"SCUOLA PRIMARIA ""TOMMASO NATALE"" VIA LIMONE N.19",882,49.7732426304
9,536,273,263,"SCUOLA PRIMARIA ""MANTEGNA"" VIA BOLOGNI N.4",1077,49.7678737233
169,436,209,227,"SCUOLA SECOND.I GRADO ""DANTE ALIGHIERI"" VIA MARTURANO RUGGERO N.79",877,49.7149372862
113,505,260,245,"SCUOLA ELEMENTARE ""CASTROGIOVANNI"" VIA CRISTODULO AMMMIRAGLIO N.3",1017,49.6558505408
102,429,229,200,"SCUOLA SECOND.I GRADO ""DANTE ALIGHIERI"" VIA MARTURANO RUGGERO N.79",864,49.6527777778
125,457,243,214,"SCUOLA SECOND. DI I GRADO ""MATTARELLA"" VIA BONAGIA N.14",921,49.6199782845
504,507,263,244,"SCUOLA PRIMARIA ""VITTORINO DA FELTRE"" Corso Calatafimi n. 1035",1023,49.5601173021
423,473,258,215,"SCUOLA PRIMARIA ""TOMASINO BARTOLOMEO"" VIA S.MARIA DI GESU' N.89",955,49.5287958115
40,546,280,266,"SCUOLA PRIM.E DELL'INFANZ.""BONANNO"" VIA PITRE' GIUSEPPE N.183",1104,49.4565217391
369,452,231,221,SCUOLA DELL'INFANZIA ZS 10 VIA PALAZZOTTO F.P. E G.B. N. 5,914,49.4529540481
539,398,198,200,"SCUOLA PRIMARIA ""AMARI"" VIA INGRASSIA GIAN FILIPPO N.33",805,49.4409937888
264,579,318,261,"SCUOLA PRIMARIA ""TEN. ONORATO"" VIA TACITO N.34",1172,49.4027303754
352,612,321,291,"SCUOLA PRIMARIA ""VILLAGRAZIA"" VIA VILLAGRAZIA N.298",1239,49.3946731235
542,538,267,271,"SCUOLA PRIMARIA ""GABELLI"" VIA EUGENIO L'EMIRO N.30",1091,49.3125572869
163,551,270,281,"SCUOLA PRIMARIA ""IGNAZIO BUTTITTA"" VIA CIMABUE GIOVANNI N.20",1118,49.2844364937
548,454,221,233,"SCUOLA PRIMARIA ""IGNAZIO BUTTITTA"" VIA CIMABUE GIOVANNI N.20",923,49.187432286
219,511,264,247,"DIREZIONE DIDATTICA ""CAPUANA"" VIA NARBONE ALESSIO N.55",1041,49.0874159462
468,468,254,214,"SCUOLA PRIMARIA ""VITTORINO DA FELTRE"" Corso Calatafimi n. 1035",955,49.0052356021
92,418,201,217,"SCUOLA PRIMARIA ""PALAGONIA"" VIA PRINCIPE DI PALAGONIA N.46",853,49.0035169988
393,570,281,289,"SCUOLA PRIMARIA ""RISO"" VIA MONDELLO N.5",1165,48.9270386266
23,472,232,240,"SCUOLA PRIMARIA ""ETTORE ARCULEO"" VIA SCHIFANI VITO N.3",965,48.9119170984
11,594,314,280,"SCUOLA PRIMARIA ""ANDREA SOLE"" VIA MOLARA N.30",1215,48.8888888889
190,501,252,249,"SCUOLA PRIMARIA ""NUOVO PAGLIARELLI"" VIA VILLANI GIOVANNI N.40",1025,48.8780487805
418,434,234,200,"SCUOLA PRIMARIA ""DI BARTOLO"" LUNGOMARE COLOMBO CRISTOFORO N.240",888,48.8738738739
565,341,176,165,"SCUOLA PRIMARIA ""TOMMASO NATALE"" VIA LIMONE N.19",698,48.8538681948
122,465,219,246,"SCUOLA PRIMARIA ""LA MASA"" VIA LA MASA GIUSEPPE N.17",952,48.8445378151
101,524,266,258,"SCUOLA SECOND. DI I GRADO ""MATTARELLA"" VIA BONAGIA N.14",1073,48.8350419385
99,485,253,232,"SCUOLA PRIMARIA ""SALGARI"" VIA PARATORE GIUSEPPE N.34",995,48.743718593
86,532,270,262,"SCUOLA PRIMARIA ""PAULSEN"" P.LE CARPINO FRANCESCO CARD. N.3",1093,48.6733760293
181,364,174,190,"SCUOLA PRIMARIA ""RAGUSA MOLETI"" VIA RAGUSA MOLETI N.8",748,48.6631016043
374,488,261,227,"SCUOLA PRIMARIA ""MANTEGNA"" VIA BOLOGNI N.4",1003,48.6540378863
182,385,183,202,"SCUOLA PRIMARIA ""RAPISARDI"" VIA CALTANISSETTA N.27",792,48.6111111111
543,418,206,212,"SCUOLA PRIMARIA ""DONAUDY"" PIAZZA DONAUDY STEFANO N.16",860,48.6046511628
415,574,288,286,"SCUOLA SEC. 1Ã?Â° GRADO ""ASTORINO"" VIA ASTORINO GERARDO N.21",1181,48.6028789162
230,454,239,215,"SCUOLA PRIMARIA ""TOMASINO BARTOLOMEO"" VIA S.MARIA DI GESU' N.89",935,48.5561497326
80,514,259,255,"SCUOLA SECOND. DI I GRADO ""MATTARELLA"" VIA BONAGIA N.14",1060,48.4905660377
321,463,239,224,"SCUOLA DELL'INFANZIA""PASS.DEI PICCIOTTI"" PASSAGGIO DEI PICCIOTTI N.3",958,48.3298538622
522,477,248,229,"SCUOLA DELL'INFANZIA ""JACK LONDON"" VIA LONDON JACK N.1/A",988,48.2793522267
17,390,188,202,"SCUOLA PRIMARIA ""MARABITTI"" VIA SPEDALIERI NICOLO' N.52",808,48.2673267327
107,429,218,211,"SCUOLA PRIMARIA ""F.CRISPI"" INGR.PAD.2 VIA BARISANO DA TRANI N.7",889,48.2564679415
372,356,186,170,"SCUOLA PRIMARIA ""DE AMICIS E"" VIA SAURO NAZARIO N.11",738,48.2384823848
2,336,166,170,"SCUOLA PRIMARIA ""MANZONI"" VIA PARLATORE FILIPPO N.56",697,48.2065997131
243,441,215,226,"SCUOLA PRIMARIA ""IGNAZIO BUTTITTA"" VIA CIMABUE GIOVANNI N.20",915,48.1967213115
376,354,179,175,"SCUOLA SECOND.DI I GRADO ""BORGESE"" PIAZZA FERRINI CONTARDO N.13",735,48.1632653061
387,566,277,289,"SCUOLA PRIMARIA ""TEN. ONORATO"" VIA TACITO N.34",1176,48.1292517007
336,477,232,245,"SCUOLA PRIMARIA ""BORGO ULIVIA"" VIA ORTIGIA N.19",992,48.0846774194
472,437,217,220,"SCUOLA SECOND.I GR.""TOMASI DI LAMPEDUSA"" VIALE LEONARDO DA VINCI N.504",909,48.0748074807
236,449,223,226,"SCUOLA SECOND.I GR.""LEONARDO DA VINCI"" VIA SERRADIFALCO N.190",934,48.0728051392
549,341,173,168,"SCUOLA PRIMARIA ""RAGUSA MOLETI"" VIA RAGUSA MOLETI N.8",710,48.0281690141
233,425,208,217,"SCUOLA PRIMARIA E DELL'INF.""IEVOLELLA"" VIA SERRADIFALCO N.3",885,48.0225988701
541,437,205,232,"SCUOLA PRIMARIA ""BRAGAGLIA"" VIA BRAGAGLIA MARINELLA N.23",911,47.9692645445
361,427,224,203,"SCUOLA PRIMARIA ""F.CRISPI"" INGR.PAD.1 VIA BARISANO DA TRANI N.7",892,47.869955157
276,386,205,181,"SCUOLA PRIMARIA ""MEDAGLIE D'ORO"" VIA DEODATO PIER LUIGI N.7",807,47.8314745973
124,394,204,190,"SCUOLA PRIMARIA ""ETTORE ARCULEO"" VIA SCHIFANI VITO N.3",824,47.8155339806
313,458,241,217,"SCUOLA ELEMENTARE ""CASTROGIOVANNI"" VIA CRISTODULO AMMMIRAGLIO N.3",958,47.8079331942
214,462,246,216,"SCUOLA MATERNA COM.LE ""WHITAKER"" VIA GUERRAZZI F.SCO DOMENICO N.1",967,47.7766287487
84,457,224,233,"SCUOLA DELL'INFANZIA ""JACK LONDON"" VIA LONDON JACK N.1/A",957,47.7533960293
545,427,213,214,"SCUOLA PRIMARIA ""MANZONI"" VIA PARLATORE FILIPPO N.56",895,47.7094972067
370,441,231,210,"SCUOLA PRIM.E DELL'INFANZ.""BONANNO"" VIA PITRE' GIUSEPPE N.183",926,47.6241900648
266,486,246,240,"SCUOLA PRIMARIA ""D'ANGELO PAOLO EMILIO"" VIA S.LORENZO N.295",1023,47.5073313783
231,563,294,269,"SCUOLA PRIMARIA ""VILLAGRAZIA"" VIA VILLAGRAZIA N.298",1186,47.4704890388
189,499,260,239,"SCUOLA PRIMARIA ""BORGO ULIVIA"" VIA ORTIGIA N.19",1054,47.3434535104
398,479,231,248,"SCUOLA PRIMARIA ""SAN DOMENICO SAVIO"" VIALE DELLA RESURREZIONE N.1",1013,47.2852912142
368,389,181,208,"SCUOLA SEC.I GR.""PR.SSA ELENA DI NAPOLI"" VIA USTICA N.46",823,47.2660996355
571,493,252,241,"SCUOLA DELL'INFANZIA""PASS.DEI PICCIOTTI"" PASSAGGIO DEI PICCIOTTI N.3",1044,47.2222222222
537,388,191,197,"SCUOLA PRIMARIA E DELL'INF.""IEVOLELLA"" VIA SERRADIFALCO N.3",822,47.201946472
386,396,208,188,"SCUOLA PRIMARIA ""TEN. ONORATO"" VIA TACITO N.34",839,47.1990464839
329,473,247,226,"SCUOLA PRIMARIA ""NUOVO PAGLIARELLI"" VIA VILLANI GIOVANNI N.40",1003,47.1585244267
413,522,262,260,"SCUOLA SEC. 1Ã?Â° GRADO ""ASTORINO"" VIA ASTORINO GERARDO N.21",1109,47.0694319206
218,601,314,287,"SCUOLA PRIMARIA ""MARVUGLIA"" VIA RALLO ALBERTO N.9",1277,47.0634299139
131,387,201,186,"SCUOLA PRIMARIA ""MARABITTI"" VIA SPEDALIERI NICOLO' N.52",824,46.9660194175
225,434,222,212,"SCUOLA PRIMARIA ""ROSOLINO PILO"" VIA LA FRANCA SEBASTIANO N.70",925,46.9189189189
151,316,170,146,"SCUOLA PRIMARIA ""ETTORE ARCULEO"" VIA SCHIFANI VITO N.3",675,46.8148148148
481,442,220,222,"SCUOLA PRIM.E DELL'INF.""CASTELLANA"" VIA CASTELLANA N.40",949,46.5753424658
205,441,232,209,"SCUOLA PRIMARIA ""COLOZZA"" VIA IMERA N.32",949,46.4699683878
268,558,297,261,"SCUOLA PRIMARIA ""SAN DOMENICO SAVIO"" VIALE DELLA RESURREZIONE N.1",1201,46.4612822648
474,478,251,227,"SCUOLA PRIMARIA ""GABELLI"" VIA EUGENIO L'EMIRO N.30",1029,46.452866861
152,405,208,197,"SCUOLA PRIMARIA ""MARABITTI"" VIA SPEDALIERI NICOLO' N.52",873,46.3917525773
579,458,226,232,"SCUOLA SECOND.I GR.""LEONARDO DA VINCI"" VIA SERRADIFALCO N.190",988,46.3562753036
507,426,220,206,"SCUOLA PRIM.E DELL'INFANZ.""BONANNO"" VIA PITRE' GIUSEPPE N.183",919,46.3547334059
199,426,213,213,"SCUOLA PRIMARIA ""F.CRISPI"" INGR.PAD.1 VIA BARISANO DA TRANI N.7",920,46.3043478261
538,447,237,210,"SCUOLA PRIMARIA ""SALGARI"" VIA PARATORE GIUSEPPE N.34",967,46.2254395036
420,470,238,232,"SCUOLA PRIMARIA ""RIZZO"" VIA SERGIO PAPA I N.21/D",1017,46.2143559489
79,493,257,236,"SCUOLA DELL'INFANZIA ""JACK LONDON"" VIA LONDON JACK N.1/A",1067,46.2043111528
409,432,208,224,"SCUOLA PRIMARIA ""SAN LORENZO"" VIA S.LORENZO N.89",935,46.2032085561
224,404,194,210,"DIREZIONE DIDATTICA ""CAPUANA"" VIA NARBONE ALESSIO N.55",876,46.1187214612
256,371,191,180,"SCUOLA PRIMARIA ""LOMBARDO RADICE"" CORSO CALATAFIMI N.241",806,46.0297766749
239,464,224,240,"SCUOLA MATERNA COM.LE ""WHITAKER"" VIA GUERRAZZI F.SCO DOMENICO N.1",1010,45.9405940594
204,433,235,198,"SCUOLA PRIM.E DELL'INF.""CASTELLANA"" VIA CASTELLANA N.40",943,45.9172852598
544,370,186,184,"SCUOLA PRIM.E DELL'INFANZ.""BONANNO"" VIA PITRE' GIUSEPPE N.183",807,45.8488228005
119,396,198,198,"SCUOLA PRIMARIA ""LA MASA"" VIA LA MASA GIUSEPPE N.17",864,45.8333333333
295,451,221,230,"SCUOLA PRIMARIA ""MARVUGLIA"" VIA RALLO ALBERTO N.9",984,45.8333333333
49,382,205,177,"SCUOLA DELL'INFANZIA ""DIAZ VECCHIO"" VIA REGINA MARIA DI SICILIA N.7",834,45.8033573141
347,605,301,304,"SCUOLA PRIMARIA ""BARONE DELLA SCALA"" BAGLIO BARONE DELLA SCALA N.22",1326,45.6259426848
282,418,207,211,"SCUOLA PRIMARIA ""NATOLI"" CORSO DEI MILLE N.1486",917,45.5834242094
547,350,170,180,"SCUOLA SECOND.I GR.""LEONARDO DA VINCI"" VIA SERRADIFALCO N.190",769,45.5136540962
514,338,166,172,"SCUOLA PRIM.E DELL'INFANZ.""LAMBRUSCHINI"" VIA DON GIOVANNI MINZONI N.1",743,45.4912516824
553,441,211,230,"SCUOLA SECONDARIA I GRADO ""FEDERICO II"" VIA PIER DELLE VIGNE N.13",971,45.4170957775
450,439,229,210,"SCUOLA PRIMARIA ""VERGA"" VIA UDITORE N.21",967,45.3981385729
269,379,199,180,"SCUOLA PRIMARIA ""ROSOLINO PILO"" VIA LA FRANCA SEBASTIANO N.70",835,45.3892215569
134,467,242,225,"SCUOLA PRIMARIA ""GABELLI"" VIA EUGENIO L'EMIRO N.30",1029,45.3838678328
570,360,184,176,"SCUOLA PRIMARIA ""MEDAGLIE D'ORO"" VIA DEODATO PIER LUIGI N.7",794,45.3400503778
54,403,198,205,"SCUOLA PRIMARIA ""CAVALLARI"" CORSO DEI MILLE N.793",889,45.3318335208
356,457,219,238,"SCUOLA PRIMARIA ""BORGO ULIVIA"" VIA ORTIGIA N.19",1009,45.2923686819
371,452,228,224,"SCUOLA PRIM.E DELL'INFANZ.""BONANNO"" VIA PITRE' GIUSEPPE N.183",998,45.2905811623
458,477,250,227,"SCUOLA SECOND.I GRADO ""PIRANDELLO"" VIA DELL'USIGNOLO N.5",1055,45.2132701422
30,443,214,229,"SCUOLA SECOND.I GR.""LEONARDO DA VINCI"" VIA SERRADIFALCO N.190",980,45.2040816327
244,499,257,242,"SCUOLA PRIMARIA ""GABELLI"" VIA EUGENIO L'EMIRO N.30",1104,45.1992753623
252,451,219,232,"SCUOLA PRIMARIA ""BERNINI"" VIA PAPALEO PIETRO N.8",998,45.1903807615
78,413,212,201,"SCUOLA PRIMARIA ""F.CRISPI"" INGR.PAD.2 VIA BARISANO DA TRANI N.7",914,45.1859956236
14,366,197,169,"SCUOLA PRIMARIA ""PAULSEN"" P.LE CARPINO FRANCESCO CARD. N.3",810,45.1851851852
459,389,193,196,"SCUOLA PRIMARIA ""BORGO ULIVIA"" VIA ORTIGIA N.19",861,45.1800232288
552,394,199,195,"SCUOLA SECOND.I GR.""TOMASI DI LAMPEDUSA"" VIALE LEONARDO DA VINCI N.504",874,45.0800915332
222,445,233,212,"SCUOLA PRIMARIA ""MARVUGLIA"" VIA RALLO ALBERTO N.9",988,45.04048583
74,470,242,228,"SCUOLA PRIMARIA ""MANTEGNA"" VIA BOLOGNI N.4",1044,45.0191570881
254,371,184,187,"SCUOLA PRIMARIA ""LOMBARDO RADICE"" CORSO CALATAFIMI N.241",825,44.9696969697
273,375,185,190,"SCUOLA PRIMARIA ""LOMBARDO RADICE"" CORSO CALATAFIMI N.241",834,44.964028777
599,410,205,205,"SCUOLA PRIMARIA ""F.CRISPI"" INGR.PAD.2 VIA BARISANO DA TRANI N.7",912,44.9561403509
344,404,198,206,SCUOLA DELL'INFANZIA ZS 10 VIA PALAZZOTTO F.P. E G.B. N. 5,899,44.9388209121
388,475,257,218,"SCUOLA PRIMARIA ""TEN. ONORATO"" VIA TACITO N.34",1057,44.9385052034
454,473,229,244,"SCUOLA PRIMARIA ""NUOVO PAGLIARELLI"" VIA VILLANI GIOVANNI N.40",1053,44.9192782526
378,549,282,267,"SCUOLA PRIMARIA ""MANTEGNA"" VIA BOLOGNI N.4",1224,44.8529411765
349,544,278,266,"SCUOLA PRIMARIA ""VILLAGRAZIA"" VIA VILLAGRAZIA N.298",1213,44.847485573
255,386,199,187,"SCUOLA PRIMARIA ""F.CRISPI"" INGR.PAD.1 VIA BARISANO DA TRANI N.7",861,44.8315911731
217,458,222,236,"DIREZIONE DIDATTICA ""CAPUANA"" VIA NARBONE ALESSIO N.55",1023,44.77028348
127,535,279,256,"SCUOLA ELEMENTARE ""CASTROGIOVANNI"" VIA CRISTODULO AMMMIRAGLIO N.3",1195,44.769874477
461,298,140,158,"SCUOLA SECOND.DI I GRADO ""BORGESE"" PIAZZA FERRINI CONTARDO N.13",666,44.7447447447
595,535,267,268,"SCUOLA PRIMARIA ""VITALI"" VIA INSERRA N.1",1196,44.7324414716
589,341,182,159,"SCUOLA PRIMARIA ""OBERDAN"" VIA SPICA PIETRO N.5",763,44.6920052425
186,352,168,184,"SCUOLA PRIMARIA ""OBERDAN"" VIA SPICA PIETRO N.5",788,44.6700507614
419,443,234,209,"SCUOLA PRIMARIA ""BORGO ULIVIA"" VIA ORTIGIA N.19",992,44.6572580645
536,360,191,169,"SCUOLA PRIMARIA ""G. COSTA"" VIA UGHETTI GIOVANBATTISTA N.27",807,44.6096654275
193,416,206,210,"SCUOLA PRIMARIA ""NICOLO' TURRISI"" PZZA ORLANDO VITTORIO EMANUELE N.3",933,44.5873526259
384,463,236,227,"SCUOLA DELL'INFANZIA ""JACK LONDON"" VIA LONDON JACK N.1/A",1039,44.562078922
319,442,223,219,"SCUOLA DELL'INFANZIA ""DIAZ VECCHIO"" VIA REGINA MARIA DI SICILIA N.7",993,44.5115810675
471,376,185,191,"SCUOLA PRIMARIA ""ETTORE ARCULEO"" VIA SCHIFANI VITO N.3",845,44.4970414201
226,392,201,191,"DIREZIONE DIDATTICA ""CAPUANA"" VIA NARBONE ALESSIO N.55",881,44.494892168
359,422,221,201,"SCUOLA PRIMARIA ""BORSELLINO"" LARGO CAMASTRA N.4",949,44.4678609062
343,432,226,206,"SCUOLA PRIMARIA ""BORGO ULIVIA"" VIA ORTIGIA N.19",972,44.4444444444
377,493,271,222,"SCUOLA PRIMARIA ""MANTEGNA"" VIA BOLOGNI N.4",1110,44.4144144144
133,321,150,171,"SCUOLA PRIM.E DELL'INF.""BAVIERA"" VIA BAVIERA GIOVANNI N.22",723,44.398340249
408,426,221,205,"SCUOLA DELL'INFANZIA ""DIAZ VECCHIO"" VIA REGINA MARIA DI SICILIA N.7",962,44.2827442827
175,426,201,225,"SCUOLA PRIMARIA ""G. COSTA"" VIA UGHETTI GIOVANBATTISTA N.27",963,44.2367601246
314,437,236,201,"SCUOLA DELL'INFANZIA""PASS.DEI PICCIOTTI"" PASSAGGIO DEI PICCIOTTI N.3",989,44.1860465116
45,344,168,176,"SCUOLA PRIMARIA ""MONTEGRAPPA"" VIA ROCCELLA GUSTAVO N.37",780,44.1025641026
28,390,205,185,"SCUOLA PRIMARIA ""BORSELLINO"" LARGO CAMASTRA N.4",885,44.0677966102
345,514,267,247,"SCUOLA ELEMENTARE ""MANCINO"" VIA BELMONTE CHIAVELLI N.111/D",1167,44.0445586975
596,342,179,163,"SCUOLA SECOND.I GR.""LEONARDO DA VINCI"" VIA SERRADIFALCO N.190",779,43.9024390244
437,469,244,225,"SCUOLA PRIMARIA ""VITALI"" VIA INSERRA N.1",1072,43.75
559,454,238,216,"SCUOLA SEC. 1Â° GRADO ""SALEMI"" VIA SALEMI FRANCESCO GEN. N.22",1040,43.6538461538
584,505,258,247,"SCUOLA ELEMENTARE ""CASTROGIOVANNI"" VIA CRISTODULO AMMMIRAGLIO N.3",1158,43.609671848
455,438,234,204,"SCUOLA SECOND.I GR.""TOMASI DI LAMPEDUSA"" VIALE LEONARDO DA VINCI N.504",1005,43.5820895522
110,393,214,179,"SCUOLA SECOND. DI I GRADO ""MATTARELLA"" VIA BONAGIA N.14",902,43.5698447894
325,498,258,240,"SCUOLA PRIMARIA ""RANDAZZO"" VIA SPERONE N.79",1145,43.4934497817
261,347,176,171,"SCUOLA PRIMARIA ""AMARI"" VIA INGRASSIA GIAN FILIPPO N.33",798,43.4837092732
234,414,217,197,"SCUOLA PRIM.E DELL'INFANZ.""BONANNO"" VIA PITRE' GIUSEPPE N.183",955,43.3507853403
311,435,237,198,"SCUOLA ELEMENTARE ""CASTROGIOVANNI"" VIA CRISTODULO AMMMIRAGLIO N.3",1005,43.2835820896
444,383,194,189,"SCUOLA PRIMARIA ""DE AMICIS E"" VIA SAURO NAZARIO N.11",885,43.2768361582
438,386,192,194,"SCUOLA DELL'INFANZIA ""PALADINI"" PIAZZA CELLINI BENVENUTO N.4",892,43.2735426009
221,369,176,193,"DIREZIONE DIDATTICA ""CAPUANA"" VIA NARBONE ALESSIO N.55",853,43.2590855803
489,469,240,229,"SCUOLA PRIMARIA ""BIXIO"" VIA CASSARO N.2",1085,43.2258064516
593,436,215,221,"SCUOLA PRIMARIA ""MEDAGLIE D'ORO"" VIA DEODATO PIER LUIGI N.7",1009,43.2111000991
449,362,186,176,"SCUOLA DELL'INFANZIA ""DIAZ VECCHIO"" VIA REGINA MARIA DI SICILIA N.7",839,43.1466030989
167,412,199,213,"SCUOLA PRIM.E DELL'INF.""CASTELLANA"" VIA CASTELLANA N.40",955,43.1413612565
121,378,186,192,"SCUOLA PRIMARIA ""MONTEGRAPPA"" VIA ROCCELLA GUSTAVO N.37",877,43.1014823261
509,414,213,201,"SCUOLA PRIMARIA ""F.SCO ORESTANO"" VIA S.CIRO N.48",964,42.9460580913
69,446,230,216,"SCUOLA PRIMARIA ""CAVALLARI"" CORSO DEI MILLE N.793",1040,42.8846153846
155,374,191,183,"SCUOLA PRIMARIA ""F.CRISPI"" INGR.PAD.1 VIA BARISANO DA TRANI N.7",873,42.8407789233
340,388,199,189,"SCUOLA SECOND.DI I GRADO ""MAZZINI"" VIA DE MARIA FEDERICO N.36",906,42.825607064
424,375,175,200,"SCUOLA PRIMARIA ""MARABITTI"" VIA SPEDALIERI NICOLO' N.52",876,42.8082191781
50,412,201,211,"SCUOLA PRIMARIA ""DE AMICIS E"" VIA SAURO NAZARIO N.11",965,42.6943005181
287,412,208,204,"SCUOLA PRIMARIA ""CAVALLARI"" CORSO DEI MILLE N.793",966,42.6501035197
156,407,208,199,"SCUOLA PRIMARIA ""MARVUGLIA"" VIA RALLO ALBERTO N.9",955,42.6178010471
516,553,289,264,"SCUOLA PRIMARIA ""ANDREA SOLE"" VIA MOLARA N.30",1298,42.6040061633
263,304,159,145,"SCUOLA PRIMARIA ""AMARI"" VIA INGRASSIA GIAN FILIPPO N.33",714,42.5770308123
500,365,183,182,"SCUOLA PRIMARIA ""DE AMICIS E"" VIA SAURO NAZARIO N.11",860,42.4418604651
105,353,192,161,"SCUOLA PRIMARIA E DELL'INF. ""SALERNO"" VIA SALERNO N.19",832,42.4278846154
279,314,159,155,"SCUOLA PRIMARIA ""LOMBARDO RADICE"" CORSO CALATAFIMI N.241",742,42.3180592992
334,472,241,231,"SCUOLA PRIMARIA ""TOMASINO BARTOLOMEO"" VIA S.MARIA DI GESU' N.89",1116,42.29390681
521,364,184,180,"SCUOLA PRIMARIA ""BORSELLINO"" LARGO CAMASTRA N.4",861,42.2764227642
83,522,275,247,"SCUOLA PRIMARIA ""VITALI"" VIA INSERRA N.1",1235,42.2672064777
203,394,205,189,"SCUOLA PRIMARIA ""FILIPPO RACITI"" VIA ALIA N.16",933,42.2293676313
51,415,208,207,"SCUOLA PRIMARIA E DELL'INF. ""SALERNO"" VIA SALERNO N.19",984,42.174796748
460,444,238,206,"SCUOLA PRIMARIA ""VITALI"" VIA INSERRA N.1",1053,42.1652421652
520,396,198,198,"SCUOLA PRIMARIA ""BORSELLINO"" LARGO CAMASTRA N.4",940,42.1276595745
502,340,176,164,"SCUOLA PRIM.E DELL'INFANZ.""LAMBRUSCHINI"" VIA DON GIOVANNI MINZONI N.1",808,42.0792079208
523,310,150,160,"SCUOLA SECOND.DI I GRADO ""BORGESE"" PIAZZA FERRINI CONTARDO N.13",737,42.0624151967
58,435,226,209,"SCUOLA PRIMARIA ""COLOZZA"" VIA IMERA N.32",1035,42.0289855072
317,486,257,229,"SCUOLA PRIMARIA ""NAZARIO SAURO"" VIALE AMEDEO D'AOSTA N.20",1159,41.932700604
5,329,179,150,"SCUOLA DELL'INFANZIA""MADRE TERESA DI C."" VIA MAQUEDA N.53",785,41.9108280255
196,448,232,216,"SCUOLA PRIMARIA E DELL'INF. ""SALERNO"" VIA SALERNO N.19",1069,41.9083255379
560,304,157,147,"SCUOLA SEC.I GR.""PR.SSA ELENA DI NAPOLI"" VIA USTICA N.46",726,41.8732782369
421,457,238,219,"SCUOLA PRIMARIA ""RIZZO"" VIA SERGIO PAPA I N.21/D",1092,41.8498168498
529,423,220,203,"SCUOLA DELL'INFANZIA ""DIAZ VECCHIO"" VIA REGINA MARIA DI SICILIA N.7",1012,41.7984189723
138,475,249,226,"SCUOLA PRIMARIA ""NATOLI"" CORSO DEI MILLE N.1486",1140,41.6666666667
322,468,235,233,"SCUOLA PRIMARIA ""NAZARIO SAURO"" VIALE AMEDEO D'AOSTA N.20",1124,41.6370106762
586,374,201,173,"SCUOLA PRIMARIA ""F.SCO ORESTANO"" VIA S.CIRO N.48",899,41.6017797553
7,376,188,188,"SCUOLA PRIMARIA ""FILIPPO RACITI"" VIA ALIA N.16",905,41.546961326
272,410,201,209,"SCUOLA SECOND.DI I GRADO ""MAZZINI"" VIA DE MARIA FEDERICO N.36",987,41.5400202634
366,450,224,226,SCUOLA DELL'INFANZIA ZS 10 VIA PALAZZOTTO F.P. E G.B. N. 5,1084,41.5129151292
439,407,210,197,"SCUOLA PRIMARIA ""DE AMICIS E"" VIA SAURO NAZARIO N.11",981,41.4882772681
585,408,212,196,"SCUOLA PRIMARIA ""NATOLI"" CORSO DEI MILLE N.1486",985,41.421319797
341,303,156,147,"SCUOLA PRIMARIA ""OBERDAN"" VIA SPICA PIETRO N.5",732,41.393442623
446,376,182,194,"SCUOLA PRIMARIA ""DE AMICIS"" VIA ROSSO DI S.SECONDO N.1",909,41.3641364136
587,455,236,219,"SCUOLA PRIMARIA ""BIXIO"" VIA CASSARO N.2",1101,41.3260672116
590,374,190,184,"SCUOLA PRIMARIA ""F.P. PEREZ"" PIAZZA PEREZ FRANCESCO PAOLO N.1",909,41.1441144114
304,383,191,192,"SCUOLA PRIMARIA ""ROSOLINO PILO"" VIA LA FRANCA SEBASTIANO N.70",931,41.1385606874
120,367,188,179,"SCUOLA PRIMARIA ""MARVUGLIA"" VIA RALLO ALBERTO N.9",893,41.0974244121
482,363,180,183,"SCUOLA PRIMARIA ""G. COSTA"" VIA UGHETTI GIOVANBATTISTA N.27",884,41.0633484163
348,478,255,223,"SCUOLA PRIMARIA ""BARONE DELLA SCALA"" BAGLIO BARONE DELLA SCALA N.22",1165,41.0300429185
228,420,221,199,"SCUOLA PRIMARIA ""MEDAGLIE D'ORO"" VIA DEODATO PIER LUIGI N.7",1024,41.015625
583,335,163,172,"SCUOLA PRIMARIA ""AMARI"" VIA INGRASSIA GIAN FILIPPO N.33",818,40.9535452323
207,346,192,154,"DIREZIONE DIDATTICA ""CAPUANA"" VIA NARBONE ALESSIO N.55",847,40.8500590319
540,321,166,155,"SCUOLA PRIMARIA ""OBERDAN"" VIA SPICA PIETRO N.5",786,40.8396946565
285,345,177,168,"SCUOLA PRIMARIA ""TOMMASO NATALE"" VIA LIMONE N.19",847,40.7319952774
320,400,212,188,"SCUOLA DELL'INFANZIA ""DIAZ VECCHIO"" VIA REGINA MARIA DI SICILIA N.7",984,40.6504065041
333,386,204,182,"SCUOLA PRIMARIA ""F.SCO ORESTANO"" VIA S.CIRO N.48",950,40.6315789474
326,412,215,197,"SCUOLA PRIMARIA ""NATOLI"" CORSO DEI MILLE N.1486",1016,40.5511811024
519,282,144,138,"SCUOLA PRIMARIA ""DE AMICIS"" VIA ROSSO DI S.SECONDO N.1",696,40.5172413793
15,374,196,178,"SCUOLA PRIMARIA ""BORSELLINO"" LARGO CAMASTRA N.4",924,40.4761904762
265,293,152,141,"SCUOLA PRIMARIA ""DEL VESPRO"" VIA OS.1 N.2",724,40.4696132597
41,339,173,166,"SCUOLA PRIMARIA ""VALVERDE"" VIA VALVERDE N.2",839,40.4052443385
597,410,209,201,"SCUOLA SEC.I GR.""PR.SSA ELENA DI NAPOLI"" VIA USTICA N.46",1015,40.39408867
126,417,213,204,"SCUOLA SECONDARIA I GRADO ""FEDERICO II"" VIA PIER DELLE VIGNE N.13",1033,40.3678606002
316,452,242,210,"SCUOLA DELL'INFANZIA""PASS.DEI PICCIOTTI"" PASSAGGIO DEI PICCIOTTI N.3",1122,40.2852049911
330,367,198,169,"SCUOLA PRIMARIA ""BIXIO"" VIA CASSARO N.2",912,40.2412280702
515,393,191,202,"SCUOLA PRIMARIA ""BORGO ULIVIA"" VIA ORTIGIA N.19",977,40.2251791198
581,415,221,194,"SCUOLA DELL'INFANZIA""MADRE TERESA DI C."" VIA MAQUEDA N.53",1032,40.2131782946
308,327,167,160,"SCUOLA PRIMARIA ""F.P. PEREZ"" PIAZZA PEREZ FRANCESCO PAOLO N.1",815,40.1226993865
132,468,230,238,"SCUOLA SECONDARIA I GRADO ""FEDERICO II"" VIA PIER DELLE VIGNE N.13",1167,40.1028277635
13,463,239,224,SCUOLA ELEMENTARE FERRARA PIAZZA MAGIONE N.1,1155,40.0865800866
82,479,254,225,"SCUOLA ELEMENTARE ""MANCINO"" VIA BELMONTE CHIAVELLI N.111/D",1195,40.0836820084
550,486,261,225,"SCUOLA PRIMARIA ""BASILE"" LARGO CORLEONE N.11/T",1214,40.0329489292
588,277,140,137,"SCUOLA PRIMARIA ""PADRE PUGLISI"" VIA GIANNOTTA NICOLO' N.4",692,40.0289017341
294,311,162,149,"SCUOLA SECOND.DI I GR.""S.BOCCONE"" VIA DEL VESPRO N.72",777,40.0257400257
103,452,246,206,"SCUOLA PRIMARIA ""VITALI"" VIA INSERRA N.1",1132,39.9293286219
274,307,153,154,"SCUOLA PRIMARIA ""MONTEGRAPPA"" VIA ROCCELLA GUSTAVO N.37",769,39.921976593
284,348,179,169,"SCUOLA PRIMARIA ""GIOBERTI"" VIA LAZZARO CARMELO N.1",873,39.8625429553
323,392,201,191,"SCUOLA DELL'INFANZIA ""DIAZ VECCHIO"" VIA REGINA MARIA DI SICILIA N.7",984,39.837398374
281,315,159,156,"SCUOLA PRIMARIA ""GIOBERTI"" VIA LAZZARO CARMELO N.1",791,39.8230088496
249,301,146,155,"SCUOLA PRIMARIA ""LOMBARDO RADICE"" CORSO CALATAFIMI N.241",756,39.8148148148
36,429,217,212,"SCUOLA PRIMARIA ""VALVERDE"" VIA VALVERDE N.2",1078,39.7959183673
154,385,190,195,"SCUOLA PRIMARIA ""MARABITTI"" VIA SPEDALIERI NICOLO' N.52",968,39.7727272727
528,363,191,172,"SCUOLA PRIMARIA ""F.SCO ORESTANO"" VIA S.CIRO N.48",914,39.715536105
89,321,161,160,"SCUOLA PRIMARIA E DELL'INF. ""NUCCIO"" VIA MONGITORE ANTONINO N.4",809,39.6786155748
271,435,218,217,"SCUOLA PRIMARIA ""BASILE"" LARGO CORLEONE N.11/T",1097,39.6536007293
6,422,219,203,"SCUOLA PRIMARIA ""BASILE"" LARGO CORLEONE N.11/T",1065,39.6244131455
150,351,169,182,"SCUOLA SECOND.I GR.""LEONARDO DA VINCI"" VIA SERRADIFALCO N.190",890,39.4382022472
73,335,172,163,"SCUOLA PRIMARIA ""FILIPPO RACITI"" VIA ALIA N.16",850,39.4117647059
315,334,172,162,"SCUOLA PRIMARIA ""CAVALLARI"" CORSO DEI MILLE N.793",848,39.3867924528
112,387,194,193,"SCUOLA PRIM. E DELL'INFANZ.""L.SCIASCIA"" VIA SMITH ADAMO N.19",983,39.3692777213
531,378,200,178,"SCUOLA PRIMARIA ""NAZARIO SAURO"" VIALE AMEDEO D'AOSTA N.20",962,39.2931392931
258,425,218,207,"SCUOLA PRIMARIA ""BASILE"" LARGO CORLEONE N.11/T",1082,39.2791127542
158,344,178,166,"SCUOLA PRIMARIA ""MARABITTI"" VIA SPEDALIERI NICOLO' N.52",876,39.2694063927
29,457,243,214,SCUOLA ELEMENTARE FERRARA PIAZZA MAGIONE N.1,1164,39.2611683849
524,382,206,176,"SCUOLA PRIMARIA ""F.CRISPI"" INGR.PAD.2 VIA BARISANO DA TRANI N.7",973,39.260020555
275,318,169,149,"ISTITUTO COMPRENSIVO ""FALCONE"" VIA BASILE ERNESTO N.170",811,39.2108508015
338,429,227,202,"SCUOLA PRIMARIA ""OBERDAN"" VIA SPICA PIETRO N.5",1098,39.0710382514
211,369,192,177,"SCUOLA PRIMARIA ""COLOZZA"" VIA IMERA N.32",946,39.0063424947
292,265,136,129,"SCUOLA SECOND.DI I GR.""S.BOCCONE"" VIA DEL VESPRO N.72",681,38.9133627019
8,373,189,184,"SCUOLA DELL'INFANZIA ""JACK LONDON"" VIA LONDON JACK N.1/A",959,38.8946819604
286,280,147,133,"SCUOLA PRIMARIA ""DEL VESPRO"" VIA OS.1 N.2",720,38.8888888889
166,361,170,191,"SCUOLA PRIMARIA ""MARVUGLIA"" VIA RALLO ALBERTO N.9",932,38.7339055794
342,400,217,183,"SCUOLA PRIMARIA ""BORGO ULIVIA"" VIA ORTIGIA N.19",1033,38.7221684414
299,295,151,144,"SCUOLA SECOND.DI I GR.""S.BOCCONE"" VIA DEL VESPRO N.72",763,38.6631716907
327,405,210,195,"SCUOLA DELL'INFANZIA ""DIAZ VECCHIO"" VIA REGINA MARIA DI SICILIA N.7",1048,38.6450381679
206,396,199,197,"SCUOLA PRIMARIA ""COLOZZA"" VIA IMERA N.32",1025,38.6341463415
55,318,171,147,"SCUOLA PRIMARIA ""F.CRISPI"" INGR.PAD.2 VIA BARISANO DA TRANI N.7",825,38.5454545455
59,389,200,189,"SCUOLA PRIMARIA ""CAVALLARI"" CORSO DEI MILLE N.793",1010,38.5148514851
16,366,191,175,"SCUOLA SECOND.I GRADO ""PIRANDELLO"" VIA DELL'USIGNOLO N.5",951,38.4858044164
1,423,217,206,"SCUOLA DELL'INFANZIA""MADRE TERESA DI C."" VIA MAQUEDA N.53",1100,38.4545454545
3,356,186,170,"SCUOLA PRIM.E DELL'INF.""CASTELLANA"" VIA CASTELLANA N.40",926,38.444924406
257,349,183,166,"SCUOLA PRIMARIA ""FILIPPO RACITI"" VIA ALIA N.16",913,38.2256297919
37,376,196,180,"SCUOLA PRIMARIA ""VALVERDE"" VIA VALVERDE N.2",986,38.1338742394
71,386,191,195,"SCUOLA PRIMARIA ""F.CRISPI"" INGR.PAD.1 VIA BARISANO DA TRANI N.7",1014,38.067061144
551,332,171,161,"SCUOLA PRIMARIA ""BORSELLINO"" LARGO CAMASTRA N.4",875,37.9428571429
380,434,226,208,"SCUOLA PRIMARIA ""BASILE"" LARGO CORLEONE N.11/T",1144,37.9370629371
111,314,166,148,"SCUOLA PRIM. E DELL'INFANZ.""L.SCIASCIA"" VIA SMITH ADAMO N.19",829,37.876960193
202,366,189,177,"SCUOLA PRIMARIA ""COLOZZA"" VIA IMERA N.32",967,37.8490175801
47,344,177,167,"SCUOLA DELL'INFANZIA""PASS.DEI PICCIOTTI"" PASSAGGIO DEI PICCIOTTI N.3",912,37.7192982456
300,338,173,165,"SCUOLA PRIMARIA ""ROSOLINO PILO"" VIA LA FRANCA SEBASTIANO N.70",898,37.6391982183
159,347,184,163,"SCUOLA PRIMARIA ""MARVUGLIA"" VIA RALLO ALBERTO N.9",922,37.6355748373
188,381,193,188,"SCUOLA PRIMARIA ""BORGO ULIVIA"" VIA ORTIGIA N.19",1020,37.3529411765
232,328,166,162,"SCUOLA PRIMARIA E DELL'INF.""IEVOLELLA"" VIA SERRADIFALCO N.3",879,37.3151308305
297,325,169,156,"SCUOLA PRIMARIA ""F.P. PEREZ"" PIAZZA PEREZ FRANCESCO PAOLO N.1",872,37.2706422018
164,348,180,168,"SCUOLA PRIMARIA ""MARVUGLIA"" VIA RALLO ALBERTO N.9",934,37.2591006424
477,390,226,164,"SCUOLA PRIMARIA ""BIXIO"" VIA CASSARO N.2",1048,37.213740458
556,307,158,149,"SCUOLA PRIMARIA ""MATTARELLA"" VIALE DI VITTORIO GIUSEPPE N.7",825,37.2121212121
162,304,146,158,"SCUOLA SECOND.I GRADO ""DANTE ALIGHIERI"" VIA MARTURANO RUGGERO N.79",817,37.2093023256
220,341,173,168,"DIREZIONE DIDATTICA ""CAPUANA"" VIA NARBONE ALESSIO N.55",921,37.0249728556
427,357,184,173,"SCUOLA PRIMARIA ""MARABITTI"" VIA SPEDALIERI NICOLO' N.52",966,36.9565217391
332,351,190,161,"SCUOLA PRIMARIA ""F.SCO ORESTANO"" VIA S.CIRO N.48",956,36.7154811715
441,284,136,148,"SCUOLA PRIMARIA E DELL'INF.""IEVOLELLA"" VIA SERRADIFALCO N.3",776,36.5979381443
306,302,152,150,"SCUOLA SECOND.DI I GR.""S.BOCCONE"" VIA DEL VESPRO N.72",826,36.5617433414
31,357,191,166,"SCUOLA PRIMARIA ""FILIPPO RACITI"" VIA ALIA N.16",979,36.4657814096
229,358,193,165,"SCUOLA PRIMARIA ""F.SCO ORESTANO"" VIA S.CIRO N.48",984,36.3821138211
417,256,118,138,"SCUOLA PRIMARIA ""PADRE PUGLISI"" VIA GIANNOTTA NICOLO' N.4",705,36.3120567376
572,386,195,191,"SCUOLA PRIMARIA ""FILIPPO RACITI"" VIA ALIA N.16",1064,36.2781954887
289,316,171,145,"SCUOLA PRIMARIA ""GIOBERTI"" VIA LAZZARO CARMELO N.1",872,36.2385321101
496,281,154,127,"SCUOLA PRIMARIA ""AMARI"" VIA INGRASSIA GIAN FILIPPO N.33",777,36.1647361647
379,234,110,124,"SCUOLA PRIMARIA ""PADRE PUGLISI"" VIA GIANNOTTA NICOLO' N.4",649,36.0554699538
309,322,185,137,"SCUOLA PRIMARIA ""F.P. PEREZ"" PIAZZA PEREZ FRANCESCO PAOLO N.1",898,35.8574610245
298,249,132,117,"SCUOLA SECOND.DI I GR.""S.BOCCONE"" VIA DEL VESPRO N.72",695,35.8273381295
160,310,154,156,"SCUOLA PRIMARIA ""MARVUGLIA"" VIA RALLO ALBERTO N.9",867,35.7554786621
43,302,164,138,"SCUOLA PRIMARIA ""VALVERDE"" VIA VALVERDE N.2",846,35.6973995272
227,318,184,134,"SCUOLA PRIMARIA ""MEDAGLIE D'ORO"" VIA DEODATO PIER LUIGI N.7",891,35.6902356902
473,323,172,151,"SCUOLA SEC.I GR.""PR.SSA ELENA DI NAPOLI"" VIA USTICA N.46",909,35.5335533553
318,358,195,163,"SCUOLA PRIMARIA ""NAZARIO SAURO"" VIALE AMEDEO D'AOSTA N.20",1011,35.4104846686
566,291,154,137,"SCUOLA SEC.I GR.""PR.SSA ELENA DI NAPOLI"" VIA USTICA N.46",823,35.3584447145
57,428,222,206,"SCUOLA PRIMARIA ""TURRISI COLONNA"" PIAZZA GRAN CANCELLIERE N.1",1215,35.2263374486
582,293,142,151,"SCUOLA PRIMARIA E DELL'INF. ""NUCCIO"" VIA MONGITORE ANTONINO N.4",832,35.2163461538
305,324,162,162,"SCUOLA PRIMARIA ""F.P. PEREZ"" PIAZZA PEREZ FRANCESCO PAOLO N.1",926,34.9892008639
440,263,142,121,"SCUOLA PRIMARIA E DELL'INF.""IEVOLELLA"" VIA SERRADIFALCO N.3",752,34.9734042553
139,350,178,172,"SCUOLA SECONDARIA I GRADO ""FEDERICO II"" VIA PIER DELLE VIGNE N.13",1007,34.7567030785
425,330,168,162,"SCUOLA PRIMARIA ""MARABITTI"" VIA SPEDALIERI NICOLO' N.52",954,34.5911949686
129,369,187,182,"SCUOLA SEC.I GR.""PR.SSA ELENA DI NAPOLI"" VIA USTICA N.46",1069,34.5182413471
245,285,156,129,"SCUOLA PRIMARIA ""SCIPIONE DI CASTRO"" VIA DI CASTRO SCIPIONE N.22",828,34.4202898551
98,266,131,135,"SCUOLA PRIMARIA E DELL'INF. ""NUCCIO"" VIA MONGITORE ANTONINO N.4",774,34.3669250646
592,374,190,184,"SCUOLA PRIMARIA ""BORGO ULIVIA"" VIA ORTIGIA N.19",1091,34.2804766269
457,342,182,160,"SCUOLA SECOND. DI I GRADO ""MATTARELLA"" VIA BONAGIA N.14",998,34.2685370741
303,336,166,170,"SCUOLA PRIM.E DELL'INF.""CASTELLANA"" VIA CASTELLANA N.40",982,34.215885947
135,367,202,165,"SCUOLA SECONDARIA I GRADO ""FEDERICO II"" VIA PIER DELLE VIGNE N.13",1073,34.2031686859
95,271,143,128,"SCUOLA PRIMARIA E DELL'INF. ""NUCCIO"" VIA MONGITORE ANTONINO N.4",794,34.1309823678
267,290,147,143,"SCUOLA PRIMARIA ""AMARI"" VIA INGRASSIA GIAN FILIPPO N.33",851,34.0775558167
324,351,186,165,"SCUOLA PRIMARIA ""RANDAZZO"" VIA SPERONE N.79",1035,33.9130434783
291,237,131,106,"SCUOLA PRIMARIA ""DEL VESPRO"" VIA OS.1 N.2",702,33.7606837607
277,295,158,137,"ISTITUTO COMPRENSIVO ""FALCONE"" VIA BASILE ERNESTO N.170",876,33.6757990868
580,380,201,179,"SCUOLA PRIM. E DELL'INFANZ.""L.SCIASCIA"" VIA SMITH ADAMO N.19",1138,33.3919156415
280,370,195,175,"SCUOLA PRIMARIA ""BORGO ULIVIA"" VIA ORTIGIA N.19",1116,33.1541218638
443,250,134,116,"SCUOLA PRIMARIA ""DE AMICIS"" VIA ROSSO DI S.SECONDO N.1",756,33.0687830688
354,314,175,139,"SCUOLA PRIMARIA ""F.SCO ORESTANO"" VIA S.CIRO N.48",955,32.8795811518
373,238,119,119,"SCUOLA SEC.I GR.""PR.SSA ELENA DI NAPOLI"" VIA USTICA N.46",725,32.8275862069
527,270,126,144,"SCUOLA SECOND.I GRADO ""PIRANDELLO"" VIA DELL'USIGNOLO N.5",824,32.7669902913
85,298,165,133,ISTITUTO MAGISTRALE REGINA MARGHERITA PIAZZA CASA PROFESSA N.3/B,918,32.4618736383
402,303,164,139,"SCUOLA SEC.I GR.""PR.SSA ELENA DI NAPOLI"" VIA USTICA N.46",940,32.2340425532
75,285,133,152,"SCUOLA PRIMARIA ""F.CRISPI"" INGR.PAD.1 VIA BARISANO DA TRANI N.7",885,32.2033898305
140,341,178,163,"SCUOLA SECONDARIA I GRADO ""FEDERICO II"" VIA PIER DELLE VIGNE N.13",1061,32.1394910462
235,224,126,98,"SCUOLA PRIMARIA ""SCIPIONE DI CASTRO"" VIA DI CASTRO SCIPIONE N.22",704,31.8181818182
591,291,168,123,"SCUOLA PRIMARIA ""EX SCIASCIA"" VIA MARCHESE NICOLO' PENSABENE N.34",917,31.73391494
76,353,179,174,"SCUOLA PRIMARIA ""TURRISI COLONNA"" PIAZZA GRAN CANCELLIERE N.1",1123,31.4336598397
301,245,137,108,"SCUOLA SECOND.DI I GR.""S.BOCCONE"" VIA DEL VESPRO N.72",785,31.2101910828
247,272,145,127,"SCUOLA PRIMARIA ""LOMBARDO RADICE"" CORSO CALATAFIMI N.241",884,30.7692307692
447,251,136,115,"SCUOLA PRIMARIA ""DE AMICIS"" VIA ROSSO DI S.SECONDO N.1",817,30.7221542228
53,271,153,118,"SCUOLA PRIMARIA ""GIOBERTI"" VIA LAZZARO CARMELO N.1",886,30.5869074492
476,244,136,108,"SCUOLA PRIMARIA ""BORSELLINO"" LARGO CAMASTRA N.4",801,30.4619225968
442,270,136,134,"SCUOLA PRIMARIA ""DE AMICIS E"" VIA SAURO NAZARIO N.11",891,30.303030303
246,260,150,110,"SCUOLA PRIMARIA ""SCIPIONE DI CASTRO"" VIA DI CASTRO SCIPIONE N.22",863,30.1274623407
12,339,171,168,"SCUOLA PRIMARIA ""TURRISI COLONNA"" PIAZZA GRAN CANCELLIERE N.1",1138,29.7891036907
242,255,136,119,"SCUOLA PRIMARIA ""SCIPIONE DI CASTRO"" VIA DI CASTRO SCIPIONE N.22",857,29.7549591599
115,225,121,104,"SCUOLA PRIMARIA ""EX SCIASCIA"" VIA MARCHESE NICOLO' PENSABENE N.34",760,29.6052631579
19,358,186,172,"SCUOLA PRIMARIA ""OBERDAN"" VIA SPICA PIETRO N.5",1210,29.5867768595
259,225,123,102,"SCUOLA PRIMARIA ""DEL VESPRO"" VIA OS.1 N.2",763,29.4888597641
564,304,156,148,"SCUOLA PRIM. E DELL'INFANZ.""L.SCIASCIA"" VIA SMITH ADAMO N.19",1034,29.4003868472
406,273,139,134,"SCUOLA PRIMARIA ""MATTARELLA"" VIALE DI VITTORIO GIUSEPPE N.7",972,28.0864197531
335,293,149,144,"SCUOLA PRIMARIA ""F.SCO ORESTANO"" VIA S.CIRO N.48",1058,27.6937618147
483,225,111,114,"SCUOLA PRIMARIA ""MATTARELLA"" VIALE DI VITTORIO GIUSEPPE N.7",822,27.3722627737
594,258,131,127,"SCUOLA PRIMARIA ""G. COSTA"" VIA UGHETTI GIOVANBATTISTA N.27",957,26.9592476489
114,227,122,105,ISTITUTO MAGISTRALE REGINA MARGHERITA PIAZZA CASA PROFESSA N.3/B,853,26.611957796
475,219,104,115,"SCUOLA PRIMARIA ""MATTARELLA"" VIALE DI VITTORIO GIUSEPPE N.7",833,26.2905162065
337,286,158,128,"SCUOLA PRIMARIA ""OBERDAN"" VIA SPICA PIETRO N.5",1100,26.0
288,198,98,100,"SCUOLA PRIMARIA ""MATTARELLA"" VIALE DI VITTORIO GIUSEPPE N.7",766,25.8485639687
136,253,144,109,"SCUOLA PRIMARIA ""EX SCIASCIA"" VIA MARCHESE NICOLO' PENSABENE N.34",984,25.7113821138
241,217,114,103,"SCUOLA PRIMARIA ""SCIPIONE DI CASTRO"" VIA DI CASTRO SCIPIONE N.22",872,24.8853211009
410,209,111,98,"SCUOLA PRIMARIA ""MATTARELLA"" VIALE DI VITTORIO GIUSEPPE N.7",854,24.4730679157
399,270,154,116,"SCUOLA PRIM. E DELL'INFANZ.""L.SCIASCIA"" VIA SMITH ADAMO N.19",1111,24.302430243
10,229,121,108,"SCUOLA PRIMARIA ""EX SCIASCIA"" VIA MARCHESE NICOLO' PENSABENE N.34",946,24.2071881607
534,256,136,120,"SCUOLA PRIMARIA ""EX SCIASCIA"" VIA MARCHESE NICOLO' PENSABENE N.34",1063,24.082784572
146,399,191,208,"SCUOLA PRIMARIA ""ETTORE ARCULEO"" VIA SCHIFANI VITO N.3",1708,23.3606557377
339,256,133,123,"SCUOLA PRIMARIA ""G. COSTA"" VIA UGHETTI GIOVANBATTISTA N.27",1099,23.2939035487
72,270,151,119,"SCUOLA PRIMARIA ""TURRISI COLONNA"" PIAZZA GRAN CANCELLIERE N.1",1185,22.7848101266
569,163,84,79,"SCUOLA PRIMARIA ""MATTARELLA"" VIALE DI VITTORIO GIUSEPPE N.7",751,21.7043941411
480,233,128,105,"SCUOLA PRIM. E DELL'INFANZ.""L.SCIASCIA"" VIA SMITH ADAMO N.19",1144,20.3671328671
493,195,107,88,"SCUOLA PRIMARIA ""EX SCIASCIA"" VIA MARCHESE NICOLO' PENSABENE N.34",1051,18.5537583254
67,93,57,36,ISTITUTO MAGISTRALE REGINA MARGHERITA PIAZZA CASA PROFESSA N.3/B,789,11.7870722433
63,104,56,48,"SCUOLA PRIMARIA ""TURRISI COLONNA"" PIAZZA GRAN CANCELLIERE N.1",1909,5.4478784704
